1111111111111111111111111111111111111
10b0000000000000000000000000010000001
1001111110110000000000000b00010B00001
1001000000010000000001101111110000001
1001111100010000000001000000000000001
100000000B010000000001000000000000001
1111111111110000000001000000000000001
1000000000000000000001111111100010001
1000000000000000000000000000000010001
1000000001111110000000000000000010001
10000000000000000P0000000000000010001
1000000000000001000000000000000000001
1000000000000001000000000000010000001
1000000000000001000000000000010000001
1001111111111111000000000000010000001
1001000000000000000000000000010000001
1001000000000000000000000000010000001
1001000000000000000000000000010000001
1001000000000000111111111111110000001
10b10000000000000000000000000000b0001
1000000000000000000000000000000000001
1111111111111111111111111111111111111